W W W W W W W W W W W W W W W W W W W W W W W W W
W G G G T T T W W W W W W W W W W W W W W W W W W
G G G G G G G G G G G G G G G G G G G G G G G G G
G G G G G G G G G G G G G G G G G G G G G G G G G
G G G G G G G G G G G G G G G G G G G G G G G T T
G G G G G G G G G G G G G G G G G G G G G G G G G
G G G G G G G G G G G G G G G G G G G G G T T G G
G G G G G G G G G G G G G G G G G G G G G G G G G
G G G G G G G G G G G G G G G G G G G G G G G G G
G G G G G G G G G G G G G G G G G G G G G G G G G
G G G G G G G G G G G G G G G G G G G G G G G G G
G G G G G G G G G G G G G G G G G G G G G G G G G
G G G G G G G G G G G G G G G G G G G G G G G G G
G G G G G G G G G G G G G G G G G G G G G G G G G
G G G G G G G G G G G G G G G G G G G G G G G G G
G G G G G G G G G G G G G G G G T T T T T T G G G
G G G G G G G G G G G G G G T T T T T T G G G G T
G G G G G G G G G G G G G G G G T T T T T G G G G
G G G G G G G G G G G G G G G G G G G G G G G G G
G G G G G G G G G G G G G T T T T T G G G G G G T
G G G G G G G G G G G G G T T T T T G G G G G G G
G G G G G G G G G G G G G G T T T T T G G G G G G
G G G G G G G G G G G G G G G G G G G G G G G G G
G G G G G G G G G G G G G G G G G G T T T G G G G
G G G G G G G G G G G G G G G G G G G G G G G G G X